Energia - Energy - Énergie - Energie - Valor energético - Energia
-
1742 kJ (K)
Energie - Energiasisaldus - Evépyela - Energia - Energia Energi
-
413 kcal (KKan)
Valoare energetica - Energia - Energji - Energija - Energija - Energetická
hodnota - - UiHHiCTb
Grassi - Fat - Matières grasses - Fett - Grasas - Lípidos - Vetten
-
Rasvad - Airrapa - Ttuszcz - Zsír - Fett - Gräsimi - Tuky - Yndyra -
9,4 g(r)
Masti - Masti - Tuky - -
di cui acidi grassi saturi - of which saturates - dont acides gras
saturés - davon gesättigte Fettsäuren - de las cuales ácidos
grasos saturados - dos quais saturados - waarvan verzadigde
vetzuren - millest küllastunud rasvhapped - EK TWV onolwv
- W tym kwasy nasycone - amelyböl telített zsírsavak
3,9 g (r)
- varav mättat fett - din care acizi grasi saturati - Z toho nasytené
mastné kyseliny - nga te cilat te ngopura - od kojih zasicene
masne kiseline - od kojih zasicene masne kiseline - Z toho
nasycené mastné kyseliny -
- 3
Carboidrati - Carbohydrate - Glucides - Kohlenhydrate - Hidratos
de carbono - Hidratos de carbono - Koolhydraten - Süsivesikud -
YSatávOpaKEC, - Weglowodany - Szénhidrát - Kolhydrat - Glucide
68 g (r)
- Sacharidy - Karbohidrate - Ugljeni hidrati - Ugljikohidrati -
Sacharidy - -
di cui zuccheri - of which sugars - dont sucres - davon Zucker - de
los cuales azúcares - dos quais açúcares - waarvan suikers - millest
suhkrud - EK TWV onolwv oákxapa - W tym cukry - amelyböl cukrok
- varav sockerarter - din care zaharuri - Z toho cukry - nga te cilat
2,5 g (r)
shegerna - od kojih seceri - od kojih seceri - Z toho cukry -
caxapa - 3
Fibre - Fibre - Fibres alimentaires - Ballaststoffe - Fibra alimentaria
- Fibra - Vezels - Kiudained - (VEC - Blonnik - Rost - Fiber be
4,9 g (r)
Fibre - Vláknina - Fiber - Vlakna - Vlakna - Vlaknina -
ser
Proteine - Protein - Protéines - Eiweiß be Proteínas R Proteínas-Eiwitten -
Valgud - NOWTEÍVEC, - Bialko - Fehérje # Protein - Proteine - Bielkoviny
12 (r)
- Proteine as Proteini - Bjelancevine ⑉ Bilkoviny be the
Sale in Salt - Sel - Salz - Sal - Sal = Zout if Sool - AXáTI by Sól 10 Só NE Salt
2,7 g (r)
- Sare - Sol' Kripe of So M Sol - Sül be -
